11111111111111111
1000100P0000100C1
1C000000100000011
10C000011T0000111
10000111111000011
1T0000011100C1111
10000111111111111
100000000011111E1
10000011111C00001
10001000000001001
1C111111100C00111
11111111111111111