11111111111111111
1000100P0000100C1
1C000000100000011
10C000011T000E111
11111111111111111