1111111111111111111
11111111000000000P1
111C111111111000001
11T000000000C100011
110000T100000000111
1000111111001011111
1C00000E11111111111
1111111111111111111