111111111111111
1E0000000000001
11111C1111110C1
11111011111C001
111110000000001
111111111P00C01
111111C000C0011
1111111111111111213123