11111111111
1PCE110011
1111111111