1111111111
1P00C0C0E1
1111111111