1111111111
1P00C0CEC1
1111111111