1111111111
1P00C0C1E1
1111111111